4 5 4 5 4 5 1 2 3 3 
3 0 0 0 0 0 0 0 0 0 
3 0 0 0 0 0 0 0 0 0 
3 0 0 0 0 0 0 0 0 0 
11 0 0 0 0 0 0 0 0 0 
11 0 0 0 0 0 0 0 0 0 
11 0 0 0 0 0 0 0 0 0 
12 13 12 13 12 13 9 10 11 11

